########################################
#......................................#
#..######..............######..........#
#..#....#..............#....#..........#
#..#....#..............#....#..........#
#..######..............######..........#
#......................................#
#..............######..................#
#..............#....#..................#
#..............######..................#
#......................................#
#..######..............######..........#
#..#....#..............#....#..........#
#..######..............######..........#
#......................................#
#..............######..................#
#..............#....#..................#
#..............######..................#
#......................................#
########################################

